1111111111
1000000001
1001100001
1000011001
1000000001
1000110001
1111011001
1000000011
1110111111
1111111111
