1111111111
1000000001
1000000111
1000000001
1110000001
1000000001
1000011001
1000000011
1000000001
1111111111
